20
20
11111000001111100000
12111000001211100000
11111000001111100000
11111111111111111111
11113311111111331111
11113311111111331111
11111111111111111111
00000111110000011111
00000111210000011121
00000111110000011111
11111000001111100000
12111000001211100000
11111000001111100000
11111111111111111111
11113311111111331111
11113311111111331111
11111111111111111111
00000111110000011111
00000111210000011121
00000111110000011111