20
20
11111111110000000000
16111111110000000060
11111111110000000000
11111111110000000000
11111111110000000000
11111111111111111111
11111111111111111111
11111111111111111111
11111111333311111111
11111111311311111111
11111111311311111111
11111111333311111111
11111111111111111111
11111111111111111111
11111111111111111111
00000000001111111111
00000000001111111111
00000000001111111111
05000000001111111151
00000000001111111111