20
20
11111111110000000000
14111111110000000060
11111111110000000000
11111111110000000000
11111111110000000000
11111111111111111111
11111111111111111111
11111111111111111111
11111111333311111111
11111411311311111111
11111111311311411111
11111111333311111111
11111111111111111111
11111111111111111111
11111111111111111111
00000000001111111111
00000000001111111111
00000000001111111111
05000000001111111141
00000000001111111111